about>	about>
accelerate>	accelerate>
accurst>	accurst>
actions>	act-ion-s>
adj>	adj>
adults>	adult-s>
aeroplanes>	aero-plane-s>
aftercares>	after-care-s>
agreeably>	agree-ab-ly>
airletters>	air-letter-s>
alexics>	alex-ic-s>
allowances>	allow-ance-s>
alum>	alum>
amharics>	amhar-ic-s>
analectss>	analects-s>
anglicanisms>	anglican-ism-s>
annuals>	annual-s>
anthropophagous>	anthropophag-ous>
apathetically>	a-path-etic-ally>
appellations>	appellation-s>
aprils>	april-s>
archery>	arch-ery>
armlets>	arm-let-s>
artier>	art-i-er>
asphyxiation>	asphyxi-at-ion>
assorting>	assort-ing>
atonal>	a-ton-al>
auditions>	audit-ion-s>
autobiographically>	auto-bio-graph-ic-ally--auto-bio-graph-ical-ly>
avuncular>	avuncular>
bactria>	bactria>
balking>	balk-ing>
bandoleer>	bandoleer>
barbaritys>	barbar-ity-s>
barracuda>	barracuda>
bastions>	bastion-s>
bazaars>	bazaar-s>
befit>	be-fit>
believe>	believe>
beneficences>	beneficence-s>
bestiaries>	besti-ari-es>
bibliophiles>	biblio-phile-s>
blacklegged>	black-legg-ed>
bleats>	bleat-s>
bludgeoning>	bludgeon-ing>
bolivia>	bolivia>
boppers>	bopp-er-s>
boulevard>	boulevard>
brandying>	brandy-ing>
breastbones>	breast-bone-s>
bridecakes>	bride-cake-s>
broadcasting>	broad-cast-ing--broadcasting>
browbeating>	brow-beat-ing>
buff>	buff>
bullheadednesss>	bull-head-ed-ness-s>
burdocks>	bur-dock-s>
bushbabies>	bush-babi-es>
buzzers>	buzz-er-s>
cackles>	cackle-s>
calendering>	calender-ing>
camellias>	camellia-s>
candelabrums>	candelabrum-s>
cantilevers>	cantilever-s>
cargo>	cargo>
carsicknesss>	car-sick-ness-s>
castaways>	cast-a-way-s>
catechized>	catech-iz-ed>
caves>	cave-s>
centaurs>	centaur-s>
chablis>	chablis>
chancels>	chancel-s>
charismatic>	charismat-ic>
cheats>	cheat-s>
chessman>	chess-man>
chimerical>	chimer-ical>
chronic>	chronic>
cincture>	cincture>
cleavers>	cleav-er-s>
cliquier>	cliqu-i-er>
clotting>	clott-ing>
coadjutors>	coadjutor-s>
cochineals>	cochineal-s>
coercion>	coerc-ion>
colonizes>	colon-ize-s>
comfits>	comfit-s>
commodes>	commode-s>
compensates>	compensate-s>
comprehensives>	comprehensives>
concierges>	concierge-s>
conduits>	conduit-s>
confuciuss>	confucius-s>
connections>	connect-ion-s>
consolidations>	con-solid-at-ion-s>
consumer>	consum-er>
contours>	contour-s>
convene>	convene>
copyholder>	copy-hold-er>
corns>	corn-s>
corses>	corse-s>
cottontail>	cotton-tail>
counterpoint>	counter-point>
coven>	coven>
crabgrasss>	crab-grass-s>
cravats>	cravat-s>
cremation>	cremat-ion>
crispest>	crisp-est>
crucially>	cruc-ial-ly>
cubic>	cub-ic>
cupbearers>	cup-bear-er-s>
curtailments>	curtail-ment-s>
cyclamates>	cyclamate-s>
daffodils>	daffodil-s>
dandruffs>	dandruff-s>
deathlessly>	dea-th-less-ly>
deceivers>	deceiv-er-s>
decor>	decor>
defects>	defect-s>
degrees>	degree-s>
deltas>	delta-s>
demoralize>	de-moral-ize>
depilations>	depilation-s>
deride>	deride>
desolating>	desolat-ing>
dethroned>	de-thron-ed>
dewlaps>	dew-lap-s>
dictaphones>	dictaphone-s>
dildos>	dildo-s>
dippers>	dipp-er-s>
disassociating>	dis-associat-ing>
discounts>	dis-count-s>
disgruntles>	disgruntle-s>
dismemberments>	dis-member-ment-s>
disputes>	dispute-s>
distastefulnesss>	dis-taste-ful-ness-s--dis-tasteful-ness-s>
divergences>	divergence-s>
dockets>	docket-s>
dogwood>	dog-wood>
doorcases>	door-case-s>
dozed>	doz-ed>
drawings>	drawing-s>
druggist>	drugg-ist>
dues>	due-s---dues>
duress>	duress>
eaglets>	eag-let-s---eagl-et-s>
editions>	edit-ion-s>
eggcups>	egg-cup-s>
elderflowers>	elder-flower-s>
elisions>	elis-ion-s>
embezzlement>	embezzle-ment>
emperors>	emperor-s>
encodes>	en-code-s>
engine>	engine>
enslaves>	en-slave-s>
entries>	entr-i-es>
epsoms>	epsom-s>
eructated>	eructat-ed>
estimators>	estimat-or-s>
evaluating>	e-valu-at-ing>
exactitude>	exacti-tude>
excretion>	excret-ion>
exiles>	exile-s>
expletives>	expletive-s>
extenuation>	extenuat-ion>
eyedrop>	eye-drop>
factorized>	factor-iz-ed>
falsehoods>	false-hood-s>
farriers>	farrier-s>
faultily>	fault-i-ly>
feigned>	feign-ed>
festivals>	fest-iv-al-s>
fieldmice>	field-mice>
filmstrips>	film-strip-s>
firths>	firth-s>
flier>	fli-er>
florists>	flor-ist-s>
flutes>	flute-s>
fold>	fold>
footings>	footing-s>
foreground>	fore-ground>
forklift>	fork-lift>
fossilized>	fossil-iz-ed>
foxhunting>	fox-hunt-ing--foxhunting>
freshers>	fresh-er-s>
frizzles>	frizzle-s>
fryers>	fry-er-s>
fundamentals>	fundament-al-s>
fusty>	fusty>
galling>	gall-ing>
gap>	gap>
gaslights>	gas-light-s>
gazing>	gaz-ing>
gents>	gent-s>
gharry>	gharry>
girders>	gird-er-s>
glib>	glib>
gluten>	gluten>
godparents>	god-parent-s>
goods>	goods>
grabs>	grab-s>
granules>	granule-s>
greatest>	great-est>
grimaces>	grimace-s>
guarded>	guard-ed--guarded>
gullies>	gulli-es>
gutturals>	guttural-s>
hag>	hag>
hankerings>	hankering-s>
harmonics>	harmon-ic-s>
hatfuls>	hat-ful-s>
headachier>	head-ach-i-er>
hearths>	hearth-s>
heehaws>	heehaw-s>
henbanes>	hen-bane-s>
heterogeneously>	heterogeneous-ly>
hippos>	hippo-s>
hogsheads>	hog-s-head-s>
homing>	hom-ing--homing>
hooters>	hoot-er-s>
horsewhips>	horse-whip-s>
housefather>	house-father>
hungry>	hungry>
hydraulics>	hydraulic-s>
idiom>	idiom>
illumination>	illuminat-ion>
immunization>	immun-iz-ation>
impingements>	impinge-ment-s>
improbable>	im-probable>
inborn>	in-bor-n>
incompetency>	in-compet-ency>
indecipherabilitys>	in-de-cipher-abil-ity-s>
individualists>	individual-ist-s>
inexorably>	inexorab-ly>
inflows>	in-flow-s>
initiate>	initi-ate>
inquisitively>	inquisit-ive-ly>
inspectorships>	inspect-or-ship-s>
intake>	in-take>
interjections>	interject-ion-s>
interring>	interr-ing>
introversions>	introvers-ion-s>
invoice>	invoice>
irrelevances>	ir-relev-ance-s>
ivies>	ivi-es>
janitors>	janitor-s>
jerky>	jerk-y>
jobber>	jobb-er>
joules>	joule-s>
jumble>	jumble>
kappas>	kappa-s>
kibbutznik>	kibbutz-nik>
kinked>	kink-ed>
knights>	knight-s>
kris>	kris>
laddies>	ladd-ie-s>
lamps>	lamp-s>
lapels>	lapel-s>
lathes>	lathe-s>
laxations>	laxation-s>
learn>	learn>
legalizes>	legal-ize-s>
leprechauns>	leprechaun-s>
liabilitys>	liabil-ity-s>
lied>	li-ed--lied>
lights>	light-s---lights>
linear>	line-ar>
liquors>	liquor-s>
livid>	livid>
lockups>	lock-up-s>
longbow>	long-bow>
lor>	lor>
lovelorn>	love-lorn>
lugubriousness>	lugubrious-ness>
luxuriantly>	luxuri-ant-ly>
madeiras>	madeira-s>
maids>	maid-s>
malcontented>	mal-content-ed>
mandarins>	mandarin-s>
manometric>	manometr-ic>
margins>	margin-s>
marrows>	marrow-s>
masseuse>	mass-euse>
matins>	matins>
maypoles>	may-pole-s>
mediating>	mediat-ing>
melodiousnesss>	melodi-ous-ness-s>
mercers>	mercer-s>
mestizos>	mestizo-s>
mezzos>	mezzos>
midshipmens>	mid-ship-men-s>
minelayings>	mine-laying-s>
misadventures>	mis-ad-venture-s>
misfires>	mis-fire-s>
missus>	missus>
mochas>	mocha-s>
molehills>	mole-hill-s>
monkeys>	monkey-s>
moonier>	moon-i-er>
morphemics>	morphem-ic-s>
motor>	motor>
mouthwashes>	mouth-wash-es>
mulberry>	mulberry>
muscatel>	muscatel>
mutts>	mutt-s>
nakedness>	naked-ness>
nationalization>	nation-al-iz-ation>
nearsightedness>	near-sight-ed-ness>
negresses>	negr-ess-es>
neuroses>	neur-oses>
nicer>	nic-er>
niles>	nile-s>
nocturnes>	nocturne-s>
nonviolent>	non-viol-ent>
notaries>	not-ari-es>
nuggets>	nugget-s>
nympho>	nymph-o>
obliterations>	obliterat-ion-s>
occidentals>	occident-al-s>
offering>	offer-ing--offering>
okaying>	okay-ing>
ontologys>	ontology-s>
opposing>	oppos-ing>
ordinal>	ordinal>
orthodontics>	orthodontic-s>
outclass>	out-class>
outrages>	out-rage-s>
overgrowths>	over-grow-th-s>
overstates>	over-state-s>
oystercatchers>	oyster-catch-er-s>
pailfuls>	pail-ful-s>
palliations>	palliat-ion-s>
panjabi>	panjabi>
parable>	parable>
pardoning>	pardon-ing>
parsonages>	parson-age-s>
passionflowers>	passion-flower-s>
pathfinders>	path-find-er-s>
pawkinesss>	pawki-ness-s>
peelers>	peel-er-s>
peninsula>	peninsula>
perambulators>	perambulat-or-s>
periphrasis>	periphrasis>
persecutors>	persecut-or-s>
pesos>	peso-s>
pharisaisms>	pharisa-ism-s>
phonecalls>	phone-call-s>
physiologists>	physi-olog-ist-s>
pillars>	pillar-s>
pinpointed>	pin-point-ed>
pitchers>	pitch-er-s--pitcher-s>
plainchants>	plain-chant-s>
platitudinous>	platitudin-ous>
pleat>	pleat>
plumber>	plumb-er>
poetaster>	poetaster>
policewoman>	police-woman>
polypi>	polypi>
portcullises>	portcullis-es>
postcard>	post-card>
potions>	potion-s>
practised>	practis-ed--practised>
precepts>	precept-s>
prefabrication>	pre-fabricat-ion>
preposition>	preposition>
pressganging>	press-gang-ing>
pricked>	prick-ed>
prioress>	prior-ess>
procrastinate>	procrastinate>
prognosiss>	prognosis-s>
promptness>	prompt-ness>
propositions>	pro-pos-ition-s>
protester>	protest-er>
pruners>	prun-er-s>
pullets>	pullet-s>
punnet>	punnet>
pursues>	pursue-s>
pyrexs>	pyrex-s>
quarantines>	quarantine-s>
questionnaires>	quest-ionn-aire-s>
quixote>	quixote>
raconteurs>	raconteur-s>
railings>	railing-s>
ranees>	ranee-s>
rates>	rate-s>
reams>	ream-s>
recces>	recce-s>
reconcilements>	reconcile-ment-s>
redbreast>	red-breast>
refereed>	refer-e-ed>
refutations>	refut-ation-s>
reifies>	reifi-es>
relict>	relict>
remounts>	re-mount-s>
repayments>	re-pay-ment-s>
reproached>	reproach-ed>
reservist>	reserv-ist>
responding>	respond-ing>
retardation>	retard-ation>
revalue>	re-value>
revolvers>	revolv-er-s>
riddled>	riddl-ed>
rills>	rill-s>
rivers>	river-s>
rondo>	rondo>
rota>	rota>
routines>	routine-s>
rueful>	rue-ful>
runts>	runt-s>
sackings>	sack-ing-s>
sages>	sage-s>
salons>	salon-s>
sandals>	sandal-s>
sarongs>	sarong-s>
sauternes>	sauternes>
scalloped>	scallop-ed>
scientologist>	scient-olog-ist>
scowls>	scowl-s>
scrip>	scrip>
scurfs>	scurf-s>
seances>	seance-s>
secretions>	secret-ion-s>
sees>	see-s>
seneschals>	seneschal-s>
sepulchral>	sepulchr-al>
servitude>	serv-i-tude>
sexton>	sexton>
shamelessness>	shame-less-ness>
sheaths>	sheath-s>
shivers>	shiver-s>
showrooms>	show-room-s>
sibilants>	sibil-ant-s>
sieges>	siege-s>
silk>	silk>
sittings>	sitting-s>
skidpans>	skid-pan-s>
skydivings>	sky-diving-s>
slavers>	slav-er-s>
slim>	slim>
slothfulnesss>	sloth-ful-ness-s>
smalls>	small-s>
sneerer>	sneer-er>
sociables>	sociable-s>
solariums>	solarium-s>
somnambulism>	somnambul-ism>
sorties>	sortie-s>
souvenir>	souvenir>
spectres>	spectre-s>
spigot>	spigot>
spivviest>	spivv-i-est>
spools>	spool-s>
squanderers>	squander-er-s>
stabilized>	stabil-iz-ed>
staling>	stal-ing>
stares>	stare-s>
stayed>	stay-ed>
stiffeners>	stiff-en-er-s>
stockbreeders>	stock-breed-er-s>
stoolies>	stool-ie-s>
straightens>	straight-en-s>
streptomycin>	streptomycin>
stupefaction>	stupefact-ion>
sublieutenants>	sub-lieu-tenant-s>
subtenants>	sub-tenant-s>
suffragans>	suffragan-s>
summers>	summer-s>
suntans>	sun-tan-s>
supplicant>	supplic-ant>
surprises>	surprise-s>
swanks>	swank-s>
swordfish>	sword-fish>
syndicalists>	syndic-al-ist-s>
tabors>	tabor-s>
tales>	tale-s>
tannins>	tannin-s>
tarsi>	tarsi>
taxonomy>	taxonomy>
tecs>	tecs>
telephotograph>	tele-photo-graph>
tenderfoot>	tender-foot>
termites>	termite-s>
thais>	thai-s>
thermoplastics>	thermo-plastic-s>
thistledowns>	thistle-down-s>
thrives>	thrive-s>
thwarts>	thwart-s>
tigress>	tigr-ess>
tings>	ting-s>
tontines>	tont-ine-s>
torments>	torment-s>
toughness>	tough-ness>
tracksuit>	track-suit>
trammelled>	trammell-ed>
transliterating>	transliterat-ing>
travelogues>	trave-logue-s>
trendsetters>	trend-sett-er-s>
trilogy>	trilogy>
truncate>	truncate>
tulips>	tulip-s>
tweezer>	tweezer>
typed>	typ-ed>
umpteens>	umpteen-s>
unctuousness>	unctu-ous-ness>
undersecretaries>	under-secretari-es>
uneventful>	un-event-ful>
unity>	unit-y>
unrolls>	un-roll-s>
uphill>	up-hill>
usherettes>	usher-ette-s>
vaguenesss>	vague-ness-s>
variances>	variance-s>
venal>	venal>
vermifuge>	vermifuge>
vibrancys>	vibrancy-s>
villain>	villain>
viscountcy>	viscount-cy>
vodka>	vodka>
vulgarians>	vulgar-ian-s>
wait>	wait>
wants>	want-s>
warren>	warren>
watchdog>	watch-dog>
waterlogged>	water-logged>
wearied>	weari-ed>
weighing>	weigh-ing>
westchester>	westchester>
wherry>	wherry>
widen>	wid-en>
winterier>	winter-i-er>
witticisms>	witt-ic-ism-s>
woodwork>	wood-work>
wretchedly>	wretch-ed-ly>
yams>	yam-s>
ziggurats>	ziggurat-s>
